NO ./textures/4.xpm
SO ./textures/4.xpm
WE ./textures/4.xpm
EA ./textures/4.xpm

F 74,21,35
C 260,231,216

  111111111111111111
 110000000S0000000011
1110000000000000000111
 11000001111100000011
  111111     1111111